Input file name: maze19-20.txt
Output file name: maze19-20output.txt

##******************
*#                 *
*#******************
*#                 *
*#******************
*#                 *
*#******************
*##################*
******************#*
*##################*
*#**************** *
*#               * *
*#**************** *
*#               * *
*#**************** *
*#               * *
*#******************
*##################*
******************##
