19 20
  ******************
*                  *
* ******************
*                  *
* ******************
*                  *
* ******************
*                  *
****************** *
*                  *
* **************** *
*                * *
* **************** *
*                * *
* **************** *
*                * *
* ******************
*                  *
******************  