9 5
  ***
* ***
*   *
** **
** **
*  **
* ***
*   *
***  