9 7
  *****
*     *
* *** *
* * * *
* * * *
* *   *
* *****
*     *
*****  